-36
74
-24
58
000000000000000000000000000000000000000000000000000000000000000000000000000000000000000000000000000000000000000
000000000000000000000000000000000000000000000000000000000000000000000000000000000000000000000000000000000000000
000000000000000000000000000000000000000000000000000000000000000000000000000000000000000000000000000000000000000
000000000000000000000000000000000000000000000000000000000000000000000000000000000000000000000000000000000000000
000000000000000000000000000000000000000000000000000000000000000000000000000000000000000000000000000000000000000
000000000000000000000000000000000000000000000000000000000000000000000000000000000000000000000000000000000000000
000000000000000000000000000000000000000000000000000000000000000000000000000000000000000000000000000000000000000
000000000000000000000000000000000000000000000000000000000000000000000000000000000000000000000000000000000000000
000000000000000000000000000000000000000000000000000000000000000000000000000000000000000000000000000000000000000
000000000000000000000000000000000000000000000000000000000000000000000000000000000000000000000000000000000000000
000000000000000000000000000000000000000000000000000000000000000000000000000000000000000000000000000000000000000
000000000000000000000000000000000000000000000000000000000000000000000000000000000000000000000000000000000000000
000000000000000000000000000000000000000000000000000000000000000000000000000000000000000000000000000000000000000
000000000000000000000000000000000000000000000000000000000000000000000000000000000000000000000000000000000000000
000000000000000000000000000000000000000000000000000000000000000000000000000000000000000000000000000000000000000
000000000000000000000000000000000000000000000000000000000000000000000000000000000000000000000000000000000000000
000000000000000000000000000000000000000000000000000000000000000000000000000000000000000000000000000000000000000
000000000000000000000000000000000000000000000000000000000000000000000000000000000000000000000000000000000000000
000000000000000000000000000000000000000000000000000000000000000000000000000000000000000000000000000000000000000
000000000000000000000000000000000000000000000000000000000000000000000000000000000000000000000000000000000000000
000000000000000000000000000000000000000000000000000000000000000000000000000000000000000000000000000000000000000
000000000000000000000000000000000000000000000000000000000000000000000000000000000000000000000000000000000000000
000000000000000000000000000000000000000000000000000000000000000000000000000000000000000000000000000000000000000
000000000000000000000000000000000000000000000000000000000000000000000000000000000000000000000000000000000000000
000000000000000000000000000000000000000000000000000000000000000000000000000000000000000000000000000000000000000
000000000000000000000000000000000000000000000000000000000000000000000000000000000000000000000000000000000000000
000000000000000000000000000000000000000000000000000000000000000000000000000000000000000000000000000000000000000
000000000000000000000000000000000000000000000000000000000000000000000000000000000000000000000000000000000000000
000000000000000000000000000000000000000000000000000000000000000000000000000000000000000000000000000000000000000
000000000000000000000000000000000000000000000000000000000000000000000000000000000000000000000000000000000000000
000000000000000000000000000000000000000000000000000000000000000000000000000000000000000000000000000000000000000
000000000000000000000000000000000000000000000000000000000000000000000000000000000000000000000000000000000000000
000000000000000000000000000000000000000000000000000000000000000000000000000000000000000000000000000000000000000
000000000000000000000000000000000000000000000000000000000000000000000000000000000000000000000000000000000000000
000000000000000000000000000000000000000000000000000000000000000000000000000000000000000000000000000000000000000
000000000000000000000000000000000000000000000000000000000000000000000000000000000000000000000000000000000000000
000000000000000000000000000000000000000000000000000000000000000000000000000000000000000000000000000000000000000
000000000000000000000000000000000000000000000000000000000000000000000000000000000000000000000000000000000000000
000000000000000000000000000000000000000000000000000000000000000000000000000000000000000000000000000000000000000
000000000000000000000000000000000002222222222222222000000000000000000000000000000000000000000000000000000000000
000000000000002222222222222222222222222222222222222200000000000000000000000000000000000000000000000000000000000
000000000000002222222222222222222222222222222222222200000000000000000000000000000000000000000000000000000000000
000000000000002222222222222222222222222222222222222220000000000000000000000000000000000000000000000000000000000
000000000000222222222222222222222222222222222222222220000000000000000000000000000000000000000000000000000000000
000000000002222222222222222222222222222222222222222220000000000000000000000000000000000000000000000000000000000
000000000222222222222222222222222222222222222222222220000000000000000000000000000000000000000000000000000000000
000000002222222222222222222222222222222222222222222220000000000000000000000000000000000000000000000000000000000
000000022222222222222222222222222222222222222222222000000000000000000000000000000000000000000000000000000000000
000000222222222222222222222222222222222222222222222000000000000000000000000000000000000000000000000000000000000
000002222222222222222222222222222222222222222222222000000000000000000000000000000000000000000000000000000000000
000022222222222222222222222211122222222222222222222000000000000000000000000000000000000000000000000000000000000
000222222222222222222222222111111111122222222222222000000000000000000000000000000000000000000000000000000000000
000222222222222222222222221111111211122222222222222000000000000000000000000000000000000000000000000000000000000
000222222222222222222222211111111111112222222222222000000000000000000000000000000000000000000000000000000000000
002222222222222222222222211111121111112222222222222000000000000000000000000000000000000000000000000000000000000
002222222222222222222222211111111111112222222222222000000000000000000000000000000000000000000000000000000000000
002222222222222222222222211111111111112222222222220000000000000000000000000000000000000000000000000000000000000
022222222222222222222222211111111111122222222222220000000000000000000000000000000000000000000000000000000000000
022222222222222222222222111111111112222222222222220000000000000000000000000000000000000000000000000000000000000
022222222222222222222211111111111222222222222222222000000000000000000000000000000000000000000000000000000000000
022222222222111122222111111111111222222222222222222200000000000000000000000000000000000000000000000000000000000
022222222222111122221111111111111222222222222222222200000000000000000000000000000000000000000000000000000000000
022222222222111122211111111111111222222222222222222200000000000000000000000000000000000000000000000000000000000
222222222222111111111111122211111222222222222222222200000000000000000000000000000000000000000000000000000000000
222222222222111111111222222221111222222222222222222200000000000000000000000000000000000000000000000000000000000
222222222222222222222222222222222222222222222222222200000000000000000000000000000000000000000000000000000000000
222222222222222222222222222222222222222222222222222200000000000000000000000000000000000000000000000000000000000
022222222222222222222222222222222222222222222222222200000000000000000000000000000000000000000000000000000000000
022222222222222222222222222222222222222222222222222000000000000000000000000000000000000000000000000000000000000
022222222222222222222222222222222222222222222222220000000000000000000000000000000000000000000000000000000000000
002222222222222222222222222222222222222222222222200000000000000000000000000000000000000000000000000000000000000
000222222222222222222222222222222222222222222222000000000000000000000000000000000000000000000000000000000000000
000022222222222222222222222222222222222222222220000000000000000000000000000000000000000000000000000000000000000
000002222222222222222222222222000022222222200000000000000000000000000000000000000000000000000000000000000000000
000000222222222222222222222222000022222222200000000000000000000000000000000000000000000000000000000000000000000
000000002222222222222222222222000002222222200000000000000000000000000000000000000000000000000000000000000000000
000000000222222222222222222222000000000000000000000000000000000000000000000000000000000000000000000000000000000
000000000022222222222222222222000000000000000000000000000000000000000000000000000000000000000000000000000000000
000000000000000000000000000000000000000000000000000000000000000000000000000000000000000000000000000000000000000
000000000000000000000000000000000000000000000000000000000000000000000000000000000000000000000000000000000000000
000000000000000000000000000000000000000000000000000000000000000000000000000000000000000000000000000000000000000
000000000000000000000000000000000000000000000000000000000000000000000000000000000000000000000000000000000000000
000000000000000000000000000000000000000000000000000000000000000000000000000000000000000000000000000000000000000
